SLB = "countries/Svalbard.txt"
JMY = "countries/Jan Mayen.txt"
NG1 = "countries/North Greenland.txt"
SG1 = "countries/South Greenland.txt"
ERL = "countries/Norwegian Greenland.txt"
UCL = "countries/Unclaimed Land.txt"
ATC = "countries/Antarctica.txt"
OST = "countries/Österland.txt"
NOL = "countries/Norrland.txt"
SVE = "countries/Svealand.txt"
GOL = "countries/Götaland.txt"
NA2 = "countries/North Australia.txt"
HRP = "countries/Hutt River Province.txt"
BKT = "countries/Bhirkot.txt"
JJT = "countries/Jajarkot.txt"
BJA = "countries/Bajura.txt"
SYN = "countries/Salyan.txt"
BJH = "countries/Bajhang.txt"
NZG = "countries/Nazi Germany.txt"
SNW = "countries/Sanwi.txt"
GCO = "countries/Gold Coast.txt"
AHI = "countries/Ashanti.txt"
GNH = "countries/Northern Ghana.txt"
IDS = "countries/Indonesian Republic.txt"
IND = "countries/India.txt"
FR2 = "countries/Vichy France.txt"
SP2 = "countries/Nationalist Spain.txt"
AHN = "countries/Austro-Hungarian Navy.txt"
LCT = "countries/Turkish Lakes.txt"
KMN = "countries/Karaman.txt"
KRS = "countries/Karesi.txt"
AIB = "countries/Ahi.txt"
JAN = "countries/Jandar.txt"
GMY = "countries/Germiyan.txt"
AYD = "countries/Aydin.txt"
BUR = "countries/Bursa.txt"
SRN = "countries/Saruhan.txt"
MTS = "countries/Menteshe.txt"
HMD = "countries/Hamid.txt"
RMZ = "countries/Ramazan.txt"
DLK = "countries/Dulkadir.txt"
CNK = "countries/Canik.txt"
ERE = "countries/Eretna.txt"
PON = "countries/Pontus.txt"
CCG = "countries/Chungking.txt"
KGN = "countries/Kwangan.txt"
CTU = "countries/Chengtu.txt"
STI = "countries/Santai.txt"
KNM = "countries/Kansu Ma.txt"
LBG = "countries/Labrang.txt"
SKK = "countries/Sokwo Arik.txt"
NWA = "countries/Ngulwa.txt"
TGN = "countries/Tuguan.txt"
TRR = "countries/Touren.txt"
TLG = "countries/Tanglang Guowa.txt"
LMU = "countries/Langmu.txt"
SGY = "countries/Sagya.txt"
CIH = "countries/Chiang Hang.txt"
YLN = "countries/Yulin.txt"
2RA = "countries/Second Red Army.txt"
NWR = "countries/Northwestern Army.txt"
XJK = "countries/Kashgar.txt"
SUI = "countries/Suiyan.txt"
DST = "countries/Disputed Territory.txt"
AJ2 = "countries/Anjou.txt"
FAT = "countries/French Antarctica.txt"
KWF = "countries/Westphalia.txt"
RNL = "countries/FrenchRhineland.txt"
FLV = "countries/Flevoland.txt"
UYG = "countries/East Turkestan.txt"
JAK = "countries/Jammu and Kashmir.txt"
LAD = "countries/Ladakh.txt"
HIA = "countries/Himachal Pradesh.txt"
EPU = "countries/East Punjab.txt"
HRY = "countries/Haryana.txt"
RJS = "countries/Rajasthan.txt"
GUJ = "countries/Gujarat.txt"
DAD = "countries/Daman and Diu.txt"
MHS = "countries/Indian Maharashtra.txt"
GAS = "countries/Indian Goa.txt"
KRN = "countries/Karnataka.txt"
KER = "countries/Kerala.txt"
TLN = "countries/Indian Tamil Nadu.txt"
PDU = "countries/Puducherry.txt"
AHR = "countries/Andhra Pradesh.txt"
TEL = "countries/Telangana.txt"
CTS = "countries/Chhattisgarh.txt"
ODI = "countries/Indian Odisha.txt"
WBG = "countries/West Bengal.txt"
JHR = "countries/Jharkhand.txt"
BHI = "countries/Indian Bihar.txt"
ASA = "countries/Indian Assam.txt"
MEG = "countries/Meghalaya.txt"
TRU = "countries/Indian Tripura.txt"
MIZ = "countries/Mizoram.txt"
MAP = "countries/Indian Manipur.txt"
NAA = "countries/Nagaland.txt"
ARN = "countries/Arunachal Pradesh.txt"
UTP = "countries/Indian Uttar Pradesh.txt"
MDY = "countries/Indian Madhya Pradesh.txt"
DHL = "countries/Indian Delhi.txt"
URK = "countries/Uttarakhand.txt"
LAL = "countries/Los Altos.txt"
SPS = "countries/South Prussia.txt"
NSL = "countries/New Silesia.txt"
NKO = "countries/New East Prussia.txt"
TKS = "countries/Turkestan.txt"
NCA = "countries/North California.txt"
SLC = "countries/Silicon Valley.txt"
LAN = "countries/Los Angeles.txt"
UST = "countries/Ustyurt.txt"
ATY = "countries/Atyrau.txt"
PAV = "countries/Pavlodar.txt"
ATB = "countries/Aktobe.txt"
KST = "countries/Kustanay.txt"
KSU = "countries/Kokshetau.txt"
KYZ = "countries/Kyzylorda.txt"
IDL = "countries/Idel-Ural.txt"
ABR = "countries/Absaroka.txt"
FLW = "countries/West Florida.txt"
FLN = "countries/North Florida.txt"
FLE = "countries/East Florida.txt"
FLS = "countries/South Florida.txt"
NTX = "countries/North Texas.txt"
STX = "countries/South Texas.txt"
WML = "countries/Westmoreland.txt"
MKG = "countries/Muskogee.txt"
NIN = "countries/North Ingria.txt"
LAZ = "countries/Lazistan.txt"
KSR = "countries/Kars.txt"
ARS = "countries/Aras.txt"
MGH = "countries/Mughan.txt"
RKU = "countries/Red Kurdistan.txt"
BAK = "countries/Baku.txt"
SOB = "countries/South Limburg.txt"
NOB = "countries/North Limburg.txt"
WFN = "countries/West Flanders.txt"
EFN = "countries/East Flanders.txt"
LBB = "countries/Lower Brabant.txt"
UBB = "countries/Upper Brabant.txt"
WLX = "countries/West Luxembourg.txt"
EFR = "countries/East Frisia.txt"
FRL = "countries/Friesland.txt"
MTN = "countries/Mountainous Caucasia.txt"
BRZ = "countries/Berezniki.txt"
CSV = "countries/Chernyshevsky.txt"
CTA = "countries/Chita.txt"
GYY = "countries/Gayny.txt"
GRK = "countries/Gorky.txt"
IRK = "countries/Irkutsk.txt"
KAM = "countries/Kamchatka.txt"
KRT = "countries/Khromtau.txt"
KLY = "countries/Kolyma.txt"
KNY = "countries/Krasnoyarsk.txt"
MGD = "countries/Magadan.txt"
OMO = "countries/Omolon.txt"
ONG = "countries/Onega.txt"
ORS = "countries/Orsk.txt"
PSS = "countries/Plesetsk.txt"
SLK = "countries/Salekhard.txt"
SMM = "countries/Samara.txt"
SUG = "countries/Surgut.txt"
TLU = "countries/Tulum.txt"
UKH = "countries/Ukhta.txt"
VYY = "countries/Vilyuy.txt"
VYA = "countries/Vyatka.txt"
YGR = "countries/Yugra.txt"
ZLO = "countries/Zlatoust.txt"
ULK = "countries/Uralsk.txt"
ATU = "countries/Aktau.txt"
ALD = "countries/Aldan.txt"
INM = "countries/Inner Mongolia.txt"
PSK = "countries/Pskov.txt"
VRN = "countries/Voronezh.txt"
ORO = "countries/Oryol.txt"
SMO = "countries/Smolensk.txt"
KHU = "countries/Khundzia.txt"
IGR = "countries/Ingria.txt"
VRS = "countries/Voros.txt"
STS = "countries/Setos.txt"
KND = "countries/Krasnodar.txt"
STV = "countries/Stravropol.txt"
KRK = "countries/Kursk.txt"
CCR = "countries/Key West.txt"
SWB = "countries/Swabia.txt"
NS2 = "countries/New Swabia.txt"
ODS = "countries/Odessa.txt"
KHK = "countries/Kharkov.txt"
DNK = "countries/Donetsk.txt"
LUH = "countries/Luhansk.txt"
VYN = "countries/Vinnytsia.txt"
KIV = "countries/Kiev.txt"
CHV = "countries/Chernigov.txt"
DNI = "countries/Dnipropetrovsk.txt"
BOB = "countries/Bobruisk.txt"
BSV = "countries/Borisov.txt"
VTB = "countries/Vitebsk.txt"
KLM = "countries/Klimavichy.txt"
MGV = "countries/Mogilev.txt"
MZY = "countries/Mozyr.txt"
MSK = "countries/Minsk.txt"
OSH = "countries/Orsha.txt"
PLT = "countries/Polotsk.txt"
SSK = "countries/Slutsk.txt"
GOM = "countries/Gomel.txt"
RCT = "countries/Rechitsa.txt"
LPL = "countries/Lepel.txt"
PNS = "countries/Pinsk.txt"
BST = "countries/Brest.txt"
VLK = "countries/Vileika.txt"
GUR = "countries/Guria.txt"
MNG = "countries/Mingrelia.txt"
SVT = "countries/Svaneti.txt"
KKK = "countries/Kartli-Kakheti.txt"
IMR = "countries/Imereti.txt"
KTL = "countries/Kartli.txt"
KKH = "countries/Kakheti.txt"
SSH = "countries/Samtskhe.txt"
TKK = "countries/Tekke.txt"
ALY = "countries/Awlad Sidi Shaykh.txt"
AMH = "countries/Ain Madhi.txt"
MZA = "countries/Mzab.txt"
OUL = "countries/Ouargla.txt"
TGG = "countries/Touggourt.txt"
AZZ = "countries/Anazzah.txt"
MCS = "countries/Mascara.txt"
CNT = "countries/Constantine.txt"
ALH = "countries/Al Hasa.txt"
MSN = "countries/Massina.txt"
BD2 = "countries/Bida.txt"
BCH = "countries/Bauchi.txt"
ARO = "countries/Aro.txt"
STU = "countries/Samori Ture.txt"
TRZ = "countries/Trarza.txt"
ARR = "countries/Adrar.txt"
TGT = "countries/Tagant.txt"
KNN = "countries/Konni.txt"
GBR = "countries/Gobir.txt"
TSS = "countries/Tessaoua.txt"
DGR = "countries/Damagaram.txt"
EGB = "countries/Egba.txt"
AMW = "countries/Adamawa.txt"
RAZ = "countries/Rabih az Zubayr.txt"
DAK = "countries/Dar al Kuti.txt"
DMS = "countries/Dar Masalit.txt"
TBT = "countries/Tibesti.txt"
SNS = "countries/Senussi.txt"
BDR = "countries/Benadir.txt"
ABJ = "countries/Abuja.txt"
KDG = "countries/Kennedougou.txt"
IDN = "countries/Idoani.txt"
BGR = "countries/Bagirmi.txt"
NRI = "countries/Nri.txt"
BRK = "countries/Brakna.txt"
MND = "countries/Mandara.txt"
MDI = "countries/Mahdist Sudan.txt"
ZZZ = "countries/Zazzau.txt"
NJD = "countries/Nejd.txt"
PKU = "countries/Parakou.txt"
DJG = "countries/Djougou.txt"
NKK = "countries/Nikki.txt"
KWA = "countries/Kwande.txt"
WVB = "countries/Walvis Bay.txt"
BVY = "countries/Bovay.txt"
ILO = "countries/Illo.txt"
KDI = "countries/Kandi.txt"
DBO = "countries/Dagbon.txt"
ILR = "countries/Ilorin.txt"
KIM = "countries/Kaiama.txt"
SNR = "countries/Sandiro.txt"
BSS = "countries/Bussa.txt"
PSA = "countries/Poissa.txt"
BNN = "countries/Benin2.txt"
DMB = "countries/Dembo.txt"
KSJ = "countries/Kasanje.txt"
LND = "countries/Lunda.txt"
WMB = "countries/Wambu.txt"
BLU = "countries/Bailundo.txt"
CKW = "countries/Chokwe.txt"
KZM = "countries/Kazembe.txt"
BUE = "countries/Barue.txt"
GWK = "countries/Gwiriko.txt"
TTI = "countries/Tati Land.txt"
MSH = "countries/Mashonaland.txt"
MCL = "countries/Manicaland.txt"
NWD = "countries/Northwest Rhodesia.txt"
NED = "countries/Northeast Rhodesia.txt"
JPA = "countries/Japanese Antarctica.txt"
KV2 = "countries/Kivu.txt"
TCP = "countries/Transcaspia.txt"
ALS = "countries/Alash Orda.txt"
SEM = "countries/Samarkand.txt"
MEV = "countries/Merv.txt"
KGD = "countries/Karaganda.txt"
AKM = "countries/Akmola.txt"
ZHA = "countries/Zhambyl.txt"
SMY = "countries/Semey.txt"
SYM = "countries/Shymkent.txt"
AMT = "countries/Alma-Ata.txt"
KHW = "countries/Khorezm.txt"
BAI = "countries/Tyuratam.txt"
SYD = "countries/Syr Darya.txt"
AMD = "countries/Amu Darya.txt"
ZHE = "countries/Zhetisu.txt"
KUJ = "countries/Kuldja.txt"
KIZ = "countries/Kizilsu.txt"
FER = "countries/Fergana.txt"
TKE = "countries/Tekke.txt"
ERS = "countries/Ersari.txt"
CHD = "countries/Chowdur.txt"
SRY = "countries/Saryk.txt"
YMT = "countries/Yomut.txt"
NUB = "countries/1.txt"
NUR = "countries/one.txt"
GLD = "countries/Golden Horde.txt"
JRS = "countries/Jerusalem.txt"
SKR = "countries/Serbian Krajina.txt"
UR2 = "countries/Ural League.txt"
SK2 = "countries/Sark.txt"
AL2 = "countries/Alderney.txt"
DVR = "countries/The Far East.txt"
BKY = "countries/The Bukey Horde.txt"
CSK = "countries/Cossackia.txt"
KD0 = "countries/Rub al Khali Desert.txt"
SD0 = "countries/Sahara Desert.txt"
TD0 = "countries/Taklamakan Desert.txt"
TE2 = "countries/Tamil Eelam.txt"
SZ2 = "countries/Suez Canal.txt"
CIE = "countries/Cieszyn.txt"
TAI = "countries/Tai.txt"
BAC = "countries/Northern Vietnam.txt"
TNG = "countries/Tay Nguyen.txt"
LUA = "countries/Luang Phrabang.txt"
CPK = "countries/Champasak.txt"
VTN = "countries/Vientiane.txt"
WT2 = "countries/West Timor.txt"
BS2 = "countries/Bima.txt"
TD2 = "countries/Tidor.txt"
TN2 = "countries/Ternate.txt"
NMN = "countries/Naiman.txt"
KRE = "countries/Kirei.txt"
LGK = "countries/Langkat.txt"
DLI = "countries/Deli.txt"
SDG = "countries/Serdand.txt"
ASN = "countries/Asahan.txt"
SAK = "countries/Siak.txt"
IDG = "countries/Indragiri.txt"
PKL = "countries/Pakualman.txt"
SRK = "countries/Surakarta.txt"
YGY = "countries/Yogyakarta.txt"
MGG = "countries/Mangku Negaran.txt"
SBS = "countries/Sambas.txt"
MPW = "countries/Mempawah.txt"
PTK = "countries/Pontianak.txt"
KUU = "countries/Kubu.txt"
MA2 = "countries/Matan.txt"
SMP = "countries/Simpiang.txt"
KWG = "countries/Kotawaringin.txt"
SKD = "countries/Sekadau.txt"
AGG = "countries/Sanggau.txt"
MLS = "countries/Meliasi.txt"
TYN = "countries/Tayan.txt"
STG = "countries/Sintang.txt"
SLM = "countries/Selimbolu.txt"
BGL = "countries/Batang Lupar.txt"
SBW = "countries/Seberuwang.txt"
SLT = "countries/Silat.txt"
BNU = "countries/Bunut.txt"
PJS = "countries/Pijasa.txt"
SHD = "countries/Suhaid.txt"
SBB = "countries/Sabamban.txt"
KSN = "countries/Kusan.txt"
PLL = "countries/Pulau Laut.txt"
BLC = "countries/Batulicin.txt"
CTG = "countries/Cantung.txt"
BAA = "countries/Bangkalaan.txt"
MUG = "countries/Manunggul.txt"
SPH = "countries/Sampanahan.txt"
CGL = "countries/Cengal.txt"
PSR = "countries/Paser.txt"
KTK = "countries/Kutai Kartanegara.txt"
BLG = "countries/Bulungan.txt"
GGT = "countries/Gunung Tabur.txt"
SBG = "countries/Sambaliung.txt"
DGG = "countries/Donggala.txt"
TWL = "countries/Tawaeli.txt"
PAU = "countries/Palu.txt"
SGI = "countries/Sigi.txt"
KLW = "countries/Kulawi.txt"
TTL = "countries/Toli-Toli.txt"
BUO = "countries/Buol.txt"
BLM = "countries/Boalemo.txt"
GRT = "countries/Gorontalo.txt"
LMB = "countries/Limboto.txt"
ATG = "countries/Atinggola.txt"
SWW = "countries/Suwawa.txt"
KDP = "countries/Kaidipang.txt"
ITG = "countries/Itaga.txt"
BTU = "countries/Bintauna.txt"
BLA = "countries/Bolaang.txt"
BGO = "countries/Bulango.txt"
CHG = "countries/Changtang.txt"
HOR = "countries/Hor Gyade.txt"
MNO = "countries/Manado.txt"
TRJ = "countries/Toraja.txt"
SSN = "countries/Massen.txt"
LTA = "countries/Alitta.txt"
SPP = "countries/Suppa.txt"
SEG = "countries/Sidenreng.txt"
RRU = "countries/Barru.txt"
TNE = "countries/Tanete.txt"
SPE = "countries/Sopeng.txt"
WJO = "countries/Wajo.txt"
LUW = "countries/Luwu.txt"
TJO = "countries/Tojo.txt"
BGG = "countries/Banggai.txt"
BNK = "countries/Bungku.txt"
LWI = "countries/Laiwoi.txt"
EMP = "countries/Empanang.txt"
LDK = "countries/Landak.txt"
BLP = "countries/Balanipa.txt"
MMJ = "countries/Mamudju.txt"
BTG = "countries/Butung.txt"
AAA = "countries/Ala.txt"
MNR = "countries/Mandar.txt"
MAU = "countries/Mautong.txt"
PIG = "countries/Parigi.txt"
LET = "countries/Leta.txt"
KAA = "countries/Sudakana.txt"
KT2 = "countries/Kuangchouwan.txt"
KVO = "countries/Kirov.txt"
DDO = "countries/Dodecanese.txt"
DLN = "countries/Dalian.txt"
NSX = "countries/North Shansi.txt"
SCA = "countries/South Chahar.txt"
PRT = "countries/Prato.txt"
AEZ = "countries/Arezzo.txt"
SNA = "countries/Siena.txt"
GRS = "countries/Grosseto.txt"
LVR = "countries/Livorno.txt"
FLR = "countries/Florence.txt"
PIS = "countries/Pisa.txt"
SLU = "countries/Saluzzo.txt"
MOF = "countries/Monferrat.txt"
ASI = "countries/Asti.txt"
BOG = "countries/Bologna.txt"
PIO = "countries/Piombino.txt"
SAV = "countries/Savoy.txt"
MLO = "countries/Milan.txt"
JEH = "countries/Jehol.txt"
IRO = "countries/Iroquois.txt"
AFA = "countries/Afar.txt"
GBL = "countries/Gambela.txt"
TIG = "countries/Tigray.txt"
AMA = "countries/Amhara.txt"
BGZ = "countries/Benishangul Gumuz.txt"
ORM = "countries/Oromia.txt"
ADD = "countries/Addis Ababa.txt"
SNN = "countries/Southern Nations Nationalities and Peoples.txt"
SDM = "countries/Sidama.txt"
DRE = "countries/Dire Dawa.txt"
HAR = "countries/Harari.txt"
SMI = "countries/Somali.txt"
HSP = "countries/Hispaniola.txt"
WIF = "countries/West Indies.txt"
DER = "countries/Derge.txt"
ZHF = "countries/Zhefang.txt"
MAG = "countries/Mangshi.txt"
MGJ = "countries/Mengjiaodong.txt"
MNH = "countries/Menghan.txt"
MNI = "countries/Menghai.txt"
MBN = "countries/Mengban.txt"
GNY = "countries/Ganya.txt"
LPO = "countries/Leipo.txt"
MOS = "countries/Moso.txt"
ZSO = "countries/Zuosuo.txt"
GNG = "countries/Gengma.txt"